; 19 x 11
................BBB
...BBBBBBB...P.....
.BBB.........B.....
...B........BBB....
B..B.........B.....
...................
BBBBBBBBB.BBBBBBBBB
B..................
B..................
BBB.BBBBBB.....BB..
BBB............BB..
