; Stage 01
BBBBBBBBBBBBBBBBBBBBB
BBBBBBBBBBBBBBBBBBBBB
BP...BBBBBBBBBBBBBBBB
B....BBBBBBBBBBBBBBBB
B.BBBBB.BBBBBBBBBBBBB
B.BBBBB.BBBBBBBBBBBBB
B........BBBBBBBBBBBB
BBBB.BB.BBBBBBBBBBBBB
BBBB.BB.BBBBBBBBBBBBB
BBBB....BBBBBBBBBBBBB
BBBBBBBBBBBBBBBBBBBBB
BBBBBBBBBBBBBBBBBBBBB
BBBBBBBBBBBBBBBBBBBBB
