; Stage 01
BBBBBBBBBBBBBBBBBBB
BP...BBBBBBBBBBBBBB
B....BBBBBBBBBBBBBB
B.BBBBB.BBBBBBBBBBB
B.BBBBB.BBBBBBBBBBB
B........BBBBBBBBBB
BBBB.BB.BBBBBBBBBBB
BBBB.BB.BBBBBBBBBBB
BBBB....BBBBBBBBBBB
BBBBBBBBBBBBBBBBBBB
BBBBBBBBBBBBBBBBBBB
